{
	"array":
	[
		{
			"id": "_test_11_10",
			"scenes": [ "testArena" ],
			"spawnLeft": [ "2x10_standart_left" ],
			"spawnRight": [ "2x10_standart_right" ],

			"cameraPosition": [0, 89.2, -147.0],
			"cameraRotation": [31, 0, 0],
			"cameraFov": 4.85,

			"sizeX": 10,
			"sizeZ": 11,
			"map":
			[
				  2, 1, 1, 1, 1, 1, 1, 1, 2, 2,
				2, 1, 1, 1, 1, 1, 1, 1, 1, 2,
				  1, 1, 1, 1, 1, 1, 1, 1, 1, 2,
				1, 1, 1, 1, 1, 1, 1, 1, 1, 1,
				  1, 1, 1, 1, 1, 1, 1, 1, 1, 2,
				1, 1, 1, 1, 1, 1, 1, 1, 1, 1,
				  1, 1, 1, 1, 1, 1, 1, 1, 1, 2,
				1, 1, 1, 1, 1, 1, 1, 1, 1, 1,
				  1, 1, 1, 1, 1, 1, 1, 1, 1, 2,
				2, 1, 1, 1, 1, 1, 1, 1, 1, 2,
				  2, 1, 1, 1, 1, 1, 1, 1, 2, 2
			]
		}
	]
}